為什麼聖結石會被酸而這群人不會？	質感 劇本 成員 都差很多好嗎 不要拿腎結石來污辱這群人
為什麼慶祝228會被罵可是慶端午不會？	因為屈原不是台灣人，是楚國人。
有沒有戰神阿瑞斯的八卦?	爵士就是阿瑞斯 男主角最後死了
理論與實務最脫節的系	哪個系不脫節...你問最不脫節的簡單多了...
為什麼PTT這麼多人看棒球	肥宅才看棒球　系壘一堆胖子
為什麼達摩祖師傳那麼好看?	達摩從頭到尾都是被動 (別人問他問題
3D小畫家有人會畫嗎？	3D小當家有人會畫嗎
對天龍人來說宜蘭4南部還４東部	他國事務..
機車推出uber或計程機車會怎樣	載到肥宅會很痛苦
台中的龍邦世貿有人跳樓?	曾經當過全台第一高樓，可惜不到一年
抽到海陸會被笑娘炮兵嗎	還好啦，海陸下基地常態，下好下滿。
國高中的國文	你沒看美國考GRE GMAT都要考高深的英文
當初太陽花沒有留下垃圾也會被捧？	哪有，我那時候去也是有垃圾，好像是白什麼的
世界上最難聽的國歌是哪首	中華民國國歌..根本出山的節奏 國旗歌來當國歌還比較合適
雙A的筆電到底可不可以帶進星巴克	帶那台十幾萬用一卡皮箱裝的水冷筆電 宅到出水
歐陽妮妮的男友看到她爸會有感覺嗎？	妮妮的媽媽很愛揍兔子布偶
有沒有imgurㄉ八卦？	不要浪費人家空間好嗎
當年的潮物搖搖筆是噱頭嗎？	2020搖搖筆好用阿 用了至少10年
肥宅初夜可以賣多少？	肥宅還是去打手槍吧
+006是什麼地方打來的電話	你被國際盜懶覺集團盯上了
為何北韓不走向新加坡的模式	又缺水又缺電 所以水電又超貴的新加坡設廠
推文速度跟五月天live聊天室滑速哪個快	聊甜柿華起來
轉筆兼具速度與華麗的極致是？	轉一萬次後說不定你比他們更厲害呢
下午茶吃到飽的起手式？	先吃冷的海鮮生魚片 然後吃熱炸的海鮮 飲料不要喝太多
兇的女生484都很胸	我看都是醜的比較凶
身為專業人士會把專業東西隨身攜帶嗎？	身為專業的肥宅 都會把脂肪放在身上
台灣的運動是不是只能靠原住民了？	原住民又不是台灣人 台灣人要說台語
貓貓早上是不是都不看人？	這貓貓好可愛
歐金金是哪裡的形容詞啊？	日文肉捧的音譯啊
公車到站系統到底可以多不准	你什麼時候有覺得政府交作業用的會準的錯覺？
有沒有大學排名的八卦？	高醫比台中哪兩所高啊?高醫不是只有醫類分數高嗎
有妹妹的請進	我兩個妹妹問說你到底在共三小
肥宅傳紙條給正妹 要寫什麼才有加分	本票字樣  金額  發票日  簽名
有沒有本機磁碟的八卦	A槽3.5磁片 B槽5.5磁片 菜逼八沒看過吼
V6 算第一個到40才翻紅的偶像團體嗎?	以前在台灣超紅
8+9打得贏肥宅嗎	打不贏，會因為重力繞著肥宅做圓周運動
有沒有書要細嚼慢嚥的八卦？	哪一本兒?
有沒有周格泰越來越誇張的八卦?	不就抄國外的 AKB前戲就10分鐘的歌一堆
留島不留人的說法跟侵略有差嗎?	就跟北韓要滅了美國一樣，有需要認真嗎？
大家比較信靈媒還是寵物翻譯師？	母咪靈媒師 專門跟母咪溝通的肥宅
如何拒絕不喜歡的女生：（	以前看很嘴的後來老婆都很安全型 現實就是那樣
法律上無罪，代表補習班狼師無辜？	看了一本小說就說人家狼師，呵呵鬼島民智未開
留髮不留頭	還好我早就禿頭了
甲甲的老二都很大嗎？	還好我12.1///不是假假!喜歡女森!
當人好痛苦R的八卦	去中國就不用當人了
有沒有團結力量大的八卦？	下一個是華哥啦
扁鵲 華陀 李時珍 誰才是神醫?	柯P現代神醫，看胡夫人，勝文
可以推薦玖壹壹天團參加央視春晚嗎?	該去中國撈的不去
1月1日告白是不是比較容易成功?	一直愛愛愛不完
有沒有今天捷運的八卦	有！真的有多
有沒有搶2017年首篇文的卦	GG 臭肥宅沒人約 笑你～
拖了女生10年卻跟別人結婚算渣嗎？	執迷不悟拖時間 人不可能為誰改變 只會為自己改變
2016帶走了什麼？	HellKitty 麥當勞歡樂送 開門！
有沒有2017要發p幣的八卦	這時間人也太多
跟風看紅白的人是不是很多?	我是來聽演歌的 這樣才有節慶的感覺 其他就算了
有沒有網咖店員超廢的八卦阿	直接把雞塊塞進女店員的XX理阿
大部分老一輩的都很佩服崇拜王永慶？	蓋醫院 蓋學校 怎麼感覺都想騙錢
為什麼鄉民總是欺負國高中生呢QQ	如果以為選好科系就會變成比爾蓋茲那不如退學吧
天堂是不是一開始點錯素質 整個就廢掉了	剛在日本天堂玩一隻龍騎 初出生點真的重要
空姊是不是外語很棒很有國際觀	說穿ㄌ就是高空服務生 真他媽不知道在屌三小
陽台飛來獨角仙怎麼辦	了，野外採的母蟲大多都被幹翻好幾輪了
灌籃高手中未來誰是人生勝利組??	小零 晚安 有空再一起做同步率的練習吧～
水滸傳108好漢是不是甲比較多？	其實魯智深看上的是林沖娘子，原著有點到。
第一個把食物塞進豬腸的人在想什麼?	喜歡裡面的糞便味道
火車上吃G排很不道德嗎?	我都在火車上吃著火鍋唱著歌
有沒有很想睡覺的八卦？	睡妳媽逼起來嗨
同志婚姻早該合法，為何拖到今天?	什麼時候輪到近親婚姻..
宅宅可以跟二次元合法結婚了嗎	初音犯重婚罪不用負責咪
酢已女愛是不是跟德郎一樣要被冷凍了	小愛很m耶
有沒有多益很賺的八卦	比大型包裹貴
搭廉航很丟臉嗎	有的廉航的時間比一般航空還好  那當然買廉航
八卦版真的是反指標耶	其實都是內行人帶風向不想別人跟來
猴頭菇為何吃起來像雞肉口感?	因為猴頭菇是雞肉做的啊！！！你竟然不知道！！！
釋憲了,萌萌們要去砸爛專管同性戀的神嗎?	兔兒神這是第一次聽到耶
4X跟伊湄哪個紅翻黑的速度較快？	完美聖人不可犯錯是吧?
大哥和三弟原來他們有龍陽之癖	快跟軍師說啊！
成年人可以回去考私立國中嗎?	幹，你余鐵雄喔？三十幾歲還在讀國中
索多瑪跟蛾摩拉當初是毀在同性狂歡？	拿小說的事情說嘴 跟騎士團有87%像
用一張圖說故事的八卦?	還在加班，抒發一下
426的下限在哪	這樣都能崩潰 不小心聞到自由的空氣怎麼辦？
同性戀肛肛會列入性教育教科書嗎	去問關注性平的家長團體啊
矮肥宅可以加入傑尼斯家族嗎？	加入傑尼龜家族比較有希望
郭台銘跟郭泓志有什麼關係嗎？	歐漢升和歐巴馬有什麼關係？
有沒有天龍萬華地方媽媽的卦0.0??	我路過超多地方媽媽在上網不說!!錢
長到186有什麼好處嗎？	沒好處 每次鳥事第一個就想到你
正妹在可愛但性格不好也不受歡迎嗎	屁下米東東 實在有狗無聊
有沒有食戟之靈的八卦？	棄追了 膩 除了一堆後宮等開發之外沒啥好看的
有沒有Dcard比較溫馨的八卦><?	為什麼各位八卦鄉民要這麼凶，尊重包容友善好嗎？
烏龜頭要怎麼做?	沒有人在吃龜頭的 骨頭那麼多又硬
有沒有詛咒自己出去被車撞的掛？？	愛拍電影也不是這樣變成影星的吧??錢
在美國吃一餐是不是至少要10鎂?	小費可以不給 裝中國人就好
單耳常常突然耳鳴是不是要聾了@@	可能是突發性耳聾的徵兆 快去就醫
邊緣人收到地震警報了	都跑到窗邊了才來
車震	沒被刪 版主是有眼睛der
地震會先上網PO文的通常是哪種人?	我笑了 這就是勇迷水準 整天罵人垃圾
大家有收到地震預警或簡訊嗎	中華搖的時候收到，遠傳搖完才出現
在家跌倒的八卦？	傷到腦袋?可憐
請問懶趴震現在人在幹嘛	牽手護懶趴
PTT最古老的梗是什麼	我要射的時候地震就來了 只好內射我女朋友了
櫻朱音是不是最適合當老婆的AV女優	我覺得超☆也很適合
災情回報	幹看到杯子摔破笑出來 高雄左營無事
有沒有一有地震中央氣象局就會被DDOS	某新聞台表示：這是駭客攻擊
地震通知	我的也是 搖完第二次才通知
利用 油滴實驗模擬 量子世界	賽啦 內文就說是隨機的
大家很討厭核核嗎？	核核欠幹阿
學生買什麼可以保值？	去研究古董，書畫、鐘錶、相機之類的
請問有沒有現在在上班卻很想大便的八卦？	我剛剛才去大便
推 兩公約提案的是誰有掛嗎？	代價就是2020落選，再高談闊落啊
利用喪屍發展發電如何？	為什麼不加以訓練 來從事一些危險性高的工程作業
有人還在玩火線特戰隊嗎？	等自己人進密到後在喊預備射擊超好玩
甲甲說別人有小圈圈的八卦？	不講道理的是狂甲吧 真的是睜眼說瞎話 笑死
台大最邊緣的學院是哪個院？	當然是文院，哲學和人類還在水源哭哭
統一有違反公平交易法嗎?	左打味全，右踢全聯，獨霸天下
館長跟黎明打誰贏?	我愛黎明!  我愛黎明!
嘻嘻打打	媽的智障姆咪滾喇幹
FB乳首解禁？	其實大多形狀不好看啦 bra真是偉大的發明
經典電影台詞	超時空要愛裡滿滿的梗
哪一種大便最難纏？	肥宅跟健康無法連結在一起 董？
大家目前活在手機上最久的手遊？	明星三缺一、漫畫人
除了發廢文還有什麼抒壓方法	我支持KMT黨內互打
為什麼權力的遊戲修幹場景這麼真	你以為經費花在哪，砍完頭給那三條龍當伙食
怎麼現在這時間就一堆高中生在外面?	明天國中會考，很多高中都當考場，所以要下午佈置教
在底下推文推???是不是很不尊重人?	阿就看不懂阿幹
朝會	值日生表示  爽  在教室休息
這是什麼秘密符文?	50處男才能特殊召喚的陣
小蘿莉跟我說她家裡很有錢	她想靠自己賺人生第一桶金
廢除煙捐救長照可行嗎	開放吸海洛英，古柯鹼無罪，啊不就更快
楓之谷的反派勢力台戰打的贏嗎？	楓幣超越者可以啊 我覺得希拉不萌
被10隻以上的野狗圍住時，該如何脫困?	小時候遇過+1 台灣野狗真的很多..
連打三個噴嚏然後肩膀很痛是怎樣?	爸爸我好冷
第一葛幹幼女ㄉ在想什麼o'_'o??	好緊、好舒服之類的吧
2B守得住街亭嗎？	被病毒滅亡  真的會?
中興大學改甚麼名字好	當然是改回叫 臺灣總督府臺中農林專門學校
gay-->同志-->同性戀-->甲甲-->??	t的圖好讚，力與美的結合
醃鮭魚吃四罐會不會死掉？	又不是每天吃4罐  能這樣吃一年再來擔心吧
停車時排檔問題	先N檔 再手煞車.放腳煞車確定沒移動了 再打P檔
等等vr要入手要先玩什麼片	惡靈古堡！你會體會到恐怖的極致
有沒有國中英聽很難的八卦?	你幹嘛不繞過去就好
有玩傳說對決的八卦嗎?	偵測到太雷會自動設定從下往上打ㄛ
有沒有胡桃打蔬果汁的時候在想什麼的八卦？	不要在意淫我老婆了 滾
開司還要打幾年？	和也不知道還要過幾年才會掉下去
去拉斯維加斯怎麼賭才會贏	說實話 如果不會玩 就玩老虎機就好了
菜市場周邊是不是三寶集散地?	看到騎車的都想踹下去
欸，輕輕把夢也對摺?	快點喇  林北午休  等會就要開會惹
有沒有燒毀古蹟很爽的八卦?	老實說我覺得蠻好玩的，遊戲設計流暢，音樂夠煽情
小兒科的護士姊姊是不是都很可愛?	當然啊 你不知道有男童專用特殊治療房嗎?
牽手就起秋	年輕真好 再長大一點你連起秋都難
妹妹的那裡軟綿綿的 >///<	唉唉，你會後悔你大學都在耍廢的
最神秘的城市	最神祕程式:陳菊.avi
關於昨天的海底總動員3首映會	你那裏還來得及 不要投空心菜
有沒有以色列的安息日的八卦？	以色列國防軍怎麼辦
有沒有台灣twitch員工 Gshan的八卦	訂閱人數告急 給個G會
拉基蚊子嗡嗡嗡夠了沒????????	腦袋裡在開party不晃都不行
總統府女總統聽不見民眾的聲音嗎	世界若是那麼小，為何我的減薪，你聽不到
有多少錢可以退休?	退休比較保險，個人看法
便利商店的便當cp值高嗎?	飯很薄 一小層而已 吃不飽是真的...
這是林依晨嗎	看起來不太像林依晨   ＠＠
你今天微笑了嗎	這樣只有22k?!窩笑惹~
臉書看到喜歡的女生放了走光的照片的八卦	沒圖你不如說邱淑貞曝光
樹枝孤鳥還有誰能駕馭?	是\star啦！ 你斜線錯邊了 ☆
廖慧珍	應該很老了 很久以前就看到他了
有沒有記者問豬的八卦	同胞的關心
肥宅學抽菸會加分嗎？	肥宅要抽大麻
有沒有viagogo的八卦	那黃牛網站裡面很多都是來詐騙的
大學生現在都在幹嘛?	収行李好過年
想要有直升機	天災有直升機才好用 可以第一時間開去救老婆小孩
天網快上線了，我們還有幾集可以逃?	而不是拿人類當電池
期末剛結束哥哥就在看A書	考完複習一下間歇運動錯了嗎
為什麼superdry在台灣被稱作「潮牌」？	台灣現在超多顏質低的人穿
所以到底要稱「中國」還是「中國大陸」	你要叫垃圾國 王八國 共慘國都沒問題der
為什麼女生這麼喜歡笑到哭??	阿就好笑到哭啊哪裡不懂？？？？？
Subway加菜可以加到爽嗎？	真的是小妹的話 然後店長不在 店員都會給加菜吧
一般人會給孝親費嗎?	抱歉、我22k太廢沒錢給，但媽媽有政府給月退
台灣有辦法單吃北韓嗎？	一起取暖應該可以，其實最想要的是互換領導人。
年金不是都要破產 為何要推前瞻計劃?	做這個比一堆老人領錢出國玩好太多
穿低胸/短褲/緊身衣褲的女生在想什麼？	釣魚不行喔 告一次就能好幾個月不用上工了
組合學好難	你問的是離散數學裡最簡單的部分
哥吉拉.VS.金剛	想幹死金剛
一直夢到討厭的老師怎麼辦?	明天去問他   咩
機捷是不是應該要讓中間的站只上不下	我是覺的的沒有要出國的國人 都不應該去搶機捷
急!現在哪裡可以買麵非麵?	便利商店就有炒米粉了...
為什麼五燈獎 潘若迪贏L.A BOYZ	為什麼當年周杰倫參加新人王比賽第二名?
姓權該怎麼取名	那個權部同學站起來
228如果拍成大河劇會怎樣？	要不要拍外省人強姦新疆人？
遇到愛情欸騙子怎麼辦？	這個歌手我一時想不起來...
越南正妹想當台灣人表示台灣還不錯?	跟越南比起來台灣好很多沒錯
台北新北還剩哪個夜市會想去？	饒河街胡椒餅都排超多人的 吃過開封街的分店覺得還
在國外有人會說自己是中華民國人嗎	9.2%會說自己是中國人
肥宅有何人生意義與目標啊?	死前交到女友，
丹丹開在台北會不會排隊人潮爆到整個馬路	說難吃的都催眠自己說花大錢東西才好吃的天龍人吧
夾自助餐的起手式?	幹 我居然忘了炸雞腿
看到自己出現在簽名檔是什麼感覺??	我女的當然沒唧唧
為何中國要阻貶人民幣?	跟中國每次都成最大贏家一樣神奇
有沒有伍佰票很難買的八卦	晚上要買不要跟我搶
118教餐加飯	外來種只能加半碗飯，要露出天大地大的刺青才能加整
當兵一年跟考大學那年哪個最苦?	當兵 聽中隊長講話的語氣，就知道他玩兵是沒再怕的
妹妹的鮑鮑一直蹭到我懶覺怎麼辦	會不會選字
花200萬裝潢是一個什麼樣的概念?	撇開專門設計人的設計師不說也不看工班品質工錢
如果罐頭塔給遠雄蓋會怎樣	都是百貨專櫃DM
今天的政論節目是開放洗白時段嗎	只有好冰冰還再圈外聲援 真不知道該說甚麼-.-
有沒有家裡疑似出現四隻蜜蜂的八卦?	四天王還少一隻
小孩五歲還給他吮奶，會怎樣嗎?	會當鷹巢城主
菸價為什麼漲這麼少？？？？	跟星巴克一樣超潮的
年輕人若可以不繳健保 看病也不虧的八卦?	等你哪天突然發現有癌症，你會後悔沒健保
咖啡店妹紫derㄋㄟㄋㄟ快掉出來該怎辦? o'_'o	幹XD 圖王要自己釣自己喔
有沒有莊心妍的八卦	一萬個為什麼
台灣無法培養出 twice或少時一樣紅的女團?	一直說我好寂寞我好寂寞，我當下馬上轉台，然後轉頭
8+9是不是笨到無法思考後果?	可以叫他去打看不爽的人 台妹當然喜歡這款
一個人坐一桌	跟老闆說直接打包!
☺Snowbaby☺	瑞雪我老婆
台灣下一代都沒農夫了該怎麼辦！！	年輕人不願返鄉種田 卻願意遠赴澳洲種田 呵呵
料理比賽要去哪裡變出豆皮阿?	很簡單 跟旁邊的肥宅觀眾借就有了
現在還有人用蝦皮?	沒有優惠之後就跟露天一樣爛了
有沒有冰雕料理多難的八卦?	猛牛青龍斬才是最強刀工
唐伯虎點秋香給豆導拍會怎麼樣?	哇靠 小雞啄米圖
FB現在是不是不流行留言生日祝福了?	生日快樂 我生日也沒人知道 世態炎涼阿
AI警察如何判斷誰是罪犯??	預防性羈押+開門歡樂送阿
目睹別人分手怎麼辦？	跑過去唱 分手快樂~
為什麼母系社會比較落後	母系社會女人權力低???說笑話
化學老師很少去製毒的八卦？	化學老師都會去金三角買地，知道為什麼嗎
如何對待國王的八卦？	她說什麼你做什麼 沒玩過？
全聯好還是家樂福超市好	全聯廣告好，但超難買
北韓太陽節這次行銷算不算成功？	我是小胖就等大家都待命到後天再社
把可樂拉環當作戒指能追到妹嗎？	就乖乖呆在台灣就好了 浪費錢幹麻
台灣哪個已解散樂團最可惜	年紀小時聽沒感覺
義美無糖烏龍綠屌打外面手搖烏龍綠茶？	可是我之前特價喝 覺得沒那個價@@"
一線三的警察多久能升階？	蔡比八一定被電的 就跟軍中老士官電爆菜排一樣
面對欣賞你的16歲妹 你真的吃的下?	打一槍冷靜一下比較好,真吃了以後問題會很多...
何謂隻手之聲？	隻手，單手矣！故隻手之聲乃是一隻手打X之聲！
林奕含事件後我覺得不是每個女生都母豬	好男人容易被騙 就如同好女人都被渣男吃死死一樣
請問有臺灣最強youtuber的掛嗎？	AI channel 人氣上升超快
有沒有7-11奮起湖便當的八卦？	我都特地去奮起湖的7-11買奮起湖便當
有沒有味噌湯是如何做的八卦?	八卦板只有一種食譜，就是排骨酥加菜頭
常有測速改成藏有測速照相更可怕？	就會出現攻略網站，紀錄被罰的點，一年後跟沒藏一樣
周杰倫大街罵人小巷道歉在美國可以吉多	敢罵祖國的狗  中國倫ㄘ屎惹
該如何委婉地問室友是不是破處了	抓他GG看反應是不是跟以前一樣
陳國興現在在中國嗎?	在看小說 打手槍 回味中
詠春宗師打得贏徐曉冬嗎？	他沒資格拍詠春四
凌晨的推文究竟是誰在帶頭作亂	我錯惹，我願意露GG道歉 o'_'o
聽到鳥叫聲就知道要睡了	謀號，奧懶覺，跑個步也會往生，切老二吧你
要怎麼在山上活50天?	帶沙威瑪核，就能無限長，無限吃
凌晨是不是廢文高峰期？	肥宅不管作什麼都是邊緣人，哪來存在感
是不是很多人一直重新整理等廢文出現	廢物就算有錢還是很廢，叫他們請吃頓飯就機機歪歪的
大家喜歡看書嘛	我最愛性愛攝影會惹 這樣也被你這個垂奶發現
志明心情真正有影寒	是"志明心情...."吧，歌詞費文還打錯
有沒有腳抽筋的八卦？	營養不良，請補充維他命B群與鈣
能不用上課該多好	我現在好想回去當學生QQ
一個月 四萬二 不用擔心裁員  夠嗎 ?	一個人剛好,買不起房子 養不起父母小孩
攜帶怎麼念?	說一樣的人超離譜，簡直就是智_
國語女歌手誰排第一？	阿妹人氣退？機八咧 票難買的要命你說人氣退 幹…
有沒有不會吞藥丸 ?	我也可以一次吞好幾顆
有沒有apple pay在台灣普及不起來的八卦?	注定普及不起來的，台灣消費已經很方便了
高雄達人進來	復興路跟民權路交接的鵝肉攤
資源回收價格	新竹科學園區
買車炫富的人在想啥??	車子只是有錢人的玩具 不會跟你想的一樣那麼多
明天要去約會了 好緊張喔	別緊張學妹只是剛好有事要拜託你而已
手持兩把西瓜刀的八卦？	會星爆姆咪
被問混哪裡的該怎樣回答？	混沌麵加叉燒我最愛
小黃瓜為什麼叫小黃瓜	只要大家都這樣叫~那根綠綠有點長的東西就叫按摩棒
布魯斯偉恩VS東尼史塔克	你怎會有鋼鐵人有機會把阿蝙抱到外太空的幻覺
有沒有肥宅去日本可以做什麼工作的八卦?	行乞 台日友好
誰是阿妹誰是家家？	誰是阿妹?誰是阿密特?
最經典的老電影?	大國民  火車撞月球 美國新玫瑰情
台灣人哪時要覺醒??	叫小英快改國號 國旗 國歌 不要再當臭俗辣騙子
如果17直播推出成人頻道live有搞頭嗎	會有一堆人拿著手機打手槍
好萊塢的電影越來越沒梗？	很懷念以前景氣不好的時候
如果能從遊戲王拿一張卡片你最想要那張?	死者甦醒。 你去玩決斗之城就知道
打出ㄒㄅㄗ會是什麼？	要問幾次？
有沒有人不知道菲律賓現在戰爭中?	台灣都不跟進，也不內戰，不好玩
雨天會影響發文嗎?	不會 看這篇就知道
有沒有菊地凜子吃染谷將太的八卦?	實在很難聯想這兩個會一起
麥香 阿薩姆 立頓 誰是奶茶界霸主	義美和午後都不錯，但大輸手搖
你們喜歡吸包子嗎？	喜歡啊，吃的時候一定要先啾啾裡面的湯汁。
為什麼請室友幫買的薯條會少一半	我說不在屁眼，高端玩家都塞在馬眼
有沒有空運料理包跟原味一樣的卦？	這是連鎖店的秘密
巴勃羅·埃斯科瓦爾選的上臺灣總統嗎？	總統無法 議員可以
遺失物尋回	到 分局一個小時就找到犯人了
阿花吹的是誰的喇叭啊？	不是幫老外排毒嗎？
金城武最近在打什麼遊戲?	年輕時比較瘋狂，現在比較少玩了，謝謝關心
沒錢花運動給豆導拍	安哥這篇文有失水準
肥宅有被警察盤查嗎？	有呀，不過大多數都客客氣氣的，盤查口氣很重要
公民不服從的構成要件是？	至少這次運動在非暴力跟符合公益沒有符合
沒錢花運動的代表歌曲是什麼?	張震嶽-我要錢
X你XX到底是什麼	送你娘鹽巴
驗胎兒DNA也太不尊重台女了吧？？	生下來再驗也沒差，不要結婚其實驗不驗都沒差
室內設計系的文憑有沒有用？	我有乙級結果現在去做烘焙啦哈哈
用電腦預測下屆奧斯卡	黑人拿配角根本是白人拿主角完撿剩的 頗ㄏ
有沒有拔完智齒的卦	身體差，早點休息，多吃補品
有無5樓常自表的八卦？	過12點一堆深夜帳號出沒XDD
妹妹變的濕濕的是感冒了嗎?	老實說,你根本沒妹妹
西門到台北車站	啊對，南部人都軟腳蝦，走不動，抱歉抱歉
有沒有年輕時不懂，長大才懂的事	買中華民國紅十字會郵票，還覺得自己做了善事
有沒有北捷電扶梯靠左邊是需要很大勇氣	低能肥宅只敢鍵盤放話 到了日本還是乖乖站同一邊
結衣到幼幼台會取名什麼姐姐?	我老婆不會去低能節目
日本茶莊怎麼計價啊？	有錢好辦事 茶價不是重點ㄅ
台灣是不是不需要這麼多電視台	電視大概會沒落吧 本肥宅有電腦就夠惹
大家都怎麼剪鼻毛?	吃電池的電動修鼻毛器很方便呢！
為啥納粹軍官被追殺到現在	後來英美還幫國防軍洗白呢 國防軍無罪論
有沒有群健的八卦?	去問台北r先生呀，他說他想吃餿水
在公共場合被拍照可以要求對方刪掉嗎？	難怪人家說 同性戀就是人權
日本人對中國人的真實評價	我真的很喜歡看中國人罵人 超長變化又多 很精彩
現在戴口罩帽子去轉運站是不是很麻煩	現在可能是最安全的
有Ariana Grande的八卦嗎？	有露點圖麻煩站內
勝男是母豬的代表嗎？	看到下面那篇被刪就是爽
台鐵輪夜班的工作內容??	車站裡的人都有機會賣票 也一樣領月薪啊
WOW不可能被超越的掛？	不過BZ聽說在開發新遊戲了
賄選	自以為好笑喔? zz
鄭伊健會後悔古惑仔沒多拍幾部嗎	有人問包皮後悔退下嗎
看女生第一眼看腳趾的人在想什麼?	看是不是蕾絲邊
明天就要入伍了 要帶啥	12天都不要準備內褲也沒差 這樣你還敢說你是當兵
剛剛車上突然有人手沒知覺	急性中風的話他應該連講話都有困難
有沒有便利商店便當飯越來越少的八卦？	沒什麼東西可以吃才會選超商.....
有沒有臉書無敵的八卦？	沒有資料
有沒有四月望雨四首歌描述的台灣女森八卦	反正女人挑到最後  自己也是只能挑剩的而已
很喜歡李敖的長輩有甚麼特徵？	跟喜歡陳文茜的人一樣
附近住戶放養狗 放任自家狗在路上趴趴走	遇過一隻被車撞在街上亂竄 飼主還誣賴是我撞的
為什麼聽葛仲珊的歌會聽到一肚子火?	米吐，聽到她的沒辦法，一定得轉台
“普通話”中哪個字音聽起來最奇怪？	的鄉音 中國南腔北調的 很多人的發音也不一定正確
女中的體育課怎麼上游泳課?	就游啊，一次通常只有三到五人沒下水
中國兩年經驗的程序員五萬台幣請得到嗎	落伍用詞了 現在中國流行叫螞膿 喔不對 是碼農
大G妹旁邊的襯葉在想什麼	左邊只是角度不對，喬好，照騙看起來也是正妹。
邱惠美是不是過譽了	重點是她社交手腕跟人脈背景
為什麼拿坡里生意不好？	我覺得很好啊 上次跟同學去吃一直翻桌一直滿
有沒有。。。的八卦	中國人都這樣用
現在就待在家的人到底在想什麼？？	陪媽媽吃飯
obov是不是仇人很多?	太早 11點半之後比較有機會釣到
通靈少女的宮廟讓郭董經營會怎樣	韓國的通靈少女跟中分頭千年大叔鬼在一起，這才是
在台灣工作35年就可以存到1777萬元退休金	再存1776萬就可以退休囉
911的光芒是不是被聖潔放火小玉蓋住了？	幹只知道911還是因為ptt是不是老了…
低能卡會紅 是不是代表台灣很多白癡？	911會紅才是真白吃多的證明
室友在看艦娘該不該阻止他繼續看下去	看什麼艦娘 鐵血孤兒好看又寫實多了
很會猜字謎可以做什麼工作	當甲甲助手啊
台灣為什麼不發展足球?	台灣人比較適合玩卡巴迪吧
畢旅車禍倖存的兩人要怎麼走出陰霾？	我朋友比你慘 參加畢旅還要跟同學自相殘殺
有沒有舊衣回收箱的八卦	那些之後是拿去菜市場賣一件30嗎????
人生哪個階段最容易被排擠	邊緣人不分階段
發錢就會有推	1z1修害的
看中醫的密醫有效嗎?	吃中華料理去找密食醫有效嗎
電動是不是跟毒品一樣應該列管?	這樣ptt會先被管吧.....
好樂迪哪首歌點不到最遺憾？	好樂迪有我難過好嗎，兩星期前才唱過。
為啥律師都要註明自己的學歷？？	什麼學校沒差，過考試才試王道
大家平常都幾點睡	自宅警備員睡覺時間很多阿
自己的女兒給人帶綠帽	肥宅跟左手生的出女兒???有點常識好嗎
有沒有臉大胸小女巨人的八卦	錦戶笑而不語
Rushs hour 什麼都緊繃	聽起來像印度阿三的時間
鬼島是不是對女森太包容了??	說穿了 還不就是 你是不是想幹人家
馬臉和狗臉現在過得如何?	早就分了 馬狗就是自我感覺良好
急！期末考有沒有關於原住民都市生活的八	在後火車站紅燈區那邊阻街.男的就在路橋底下等拉工
中國人民為什麼可以忍受中共的八卦?	中國:中國人不適合民主
第三冊第十二課＜oWnWo小的時候＞	變成家裡蹲
為什麼金庸小說可以一直翻拍?	導演跟贊助商不是年輕人阿
現在影片都要很花俏才能上檯面的八卦？	不一定，重點是議題啦，像這個
說女生塑膠的是哪些人？	現代喝的東西充滿塑化劑 早就是塑膠懶的形狀了
哪個流行語最礙眼?	廠廠廠廠廠廠廠廠廠廠廠廠廠廠廠廠廠廠廠廠廠廠廠廠
有沒有兒童台可以播柯南的八卦?	哈煙要打碼，殺人卻跟吃飯一樣正常的歹玩~
情侶依偎在麥當勞看海賊王很糟糕嗎	國民漫阿 看了沒事
一場不公平的選舉	中華民國又滅亡啦
端午節時朋友都回來卻沒找你的八卦?	有些人平時在臉書都靠北不揪他，結果了揪了不來
The不讓超越老大了嗎??	魔術強生打前鋒的 <-- 我笑了
下雨天在四樓能幹嘛？	4F....
有沒有公審女生的男森要大家不要公審的卦	台女就是這種水準而以，欠審剛好
外國人為什麼懶叫比較大	因為台灣人被黑心食品毒害
加了「文本」句子就變高級的八卦？	有同學讀了中文相關科系後就常用，覺得好笑
台灣有什麼東西看的到別人的車尾燈?	很多車燈都台灣做的啊,  你沒開車?
17行銷是不是很厲害	糞廣告 搞的一副噁爛的8+9和母X風格
甲甲對愛滋防治的態度是?	台灣人比較少，愛汁甲卻超多，甲甲真棒
我弟問我怎麼打手槍	好好教，我小時候就是沒人教所以
有沒有正妹拍照背景都是醜的八卦?	反正你也幹不到R
118學餐其實也才這樣？是不是過譽了	不然你吃飽到對面鹿鳴堂看看價格，驚
比明星高中屌的社區高中	居軟高中最屌
一群人擠在草地上吃外食	肥宅只能一個人窩在電腦前吃垃圾食物
貓貓在睡覺？	倒好飼料餓了就會去吃 貓不會吃到撐
捨不得短短副歌	還好我有 我下一首情歌
刑警找上門怎麼辦	國際盜懶叫集團
有沒有uber在資料分析領域超神的八卦？	一個便當吃不夠 可以吃兩個
真正的 " 泡妞之王" 是誰？	那還用說當然是韋小寶
男生被說斯文算是誇獎嗎0.0	我最後一次被人說斯文是國小了
鄉民何不多利用"國發會平台"?	沒有錯，請鄉民國。們一同支持九二共識，中華民國萬
為什麼有女友的男生比較有魅力	很多女生就是這樣啊  想要好處又不想成為男女朋友
如果愛情這樣憂傷	憂傷 get!!!
為什麼越來越少想當水電工?	水電工現在只要不偷懶的 年薪都百萬以上
有沒有越來越多人畫醜貼圖的八卦？	最高境界 大巧不工
有沒有幹很多妹妹很累的八卦QQ?	幹很多手？
有沒有尼克森在中國的八卦	也不給我版權費
外拍有男的嗎	我啊 專拍大尺碼的~
我等的船還不來	任賢齊的好友為什麼會是九孔?
有沒有頂級信用卡的八卦?	你想想看用信用卡買汽車是什麼樣的感覺
認識家附近便利商店的店員好嗎	隨便應付他啊
拳擊跟綜合格鬥 哪個好?	肥宅還是打手槍好
正妹店員飲料糖加太多了怎摸半	去ㄚ 你就說「這飲料跟妳一樣太甜惹」然後就去警局
超能力者被認為是精神病患該怎辦？	shi 實際上遠遠沒這麼順利喔
坐在變電所旁如何才能阻隔電磁波的傷害?	去買八卦鏡化煞來擋
通緝犯都什麼學歷呢？	FB頁面最愛自稱念社會大學、空中大學那種人
商人無祖國是不是只適用於台灣？	祖國是中國咩，另提軍公教跟客家人原住民也是
政治經濟系好嗎?	看起來像是開給政客洗學歷的，發課表來看一下
四大名著哪一個文筆最差？	反正紅樓夢一定是第一名 科科
台女是不是不適合嫁日本人	台男一堆父權沙豬，跟日本人起碼還能打卡
覺醒青年是褒義詞還是貶義詞？	說好聽叫"覺醒"青年  講難聽叫"跟風"青年
買Luxgen的人現在想什麼？	買這種車真的很丟臉，寧可騎腳踏車
電影優惠票	這算南部小確性 ..還有不清場的2輪影院
現在還有人在玩gameboy嗎？	用手機模擬器玩不就好了現在連ps都有手機模擬器了
淡江要學店化了嗎？	淡江早就學店了，不過比台灣的共產黨大學好的多
有沒有台灣霍格華滋—文化大學的八卦?	成大有魔法學校
一夜七次郎的由來	所以你自己回完了 是要問什麼卦...？
有沒有加班錢卻領的比較少的八卦	他就可以節省超多人力成本的
妹妹不開心而且說是我害的?	你妹不開心是不會想辦法讓她開心點嗎？
有沒有亞洲人普遍把休息看成罪惡的卦?	奴種DNA 工作到死剛好而已
徐福把人帶去哪了	韓國啦 沒看韓國一直吵一堆中國東西是韓國的
停用胎盤素朴槿惠崩潰後的臉	部知道有沒有軟體可以玩人臉
我們台灣的醫學在世界上是什麼等級	輸美國?一堆回來台灣就醫的人呢?
為什麼cefiro看起來就覺得是有錢人開的	大器舒適好開啊，3.5的馬力真的猛真心不騙
大家會想像自己怎麼死嗎	真結局你絕對想不到
戀老癖跟蘿莉控應該也算是一種病吧?	不是 戀熟女很正常 你再說熟女們要森77囉
台日都愛找外國人當藝人?	日本非洲老黑很吃香
日本和台灣的便利商店差在哪?	日本商店結帳時，隊伍只會排一隊，各自往櫃台結帳
有沒有偶像聲優要會彈鋼琴和跳馬的八卦	逢田姊什麼都要會
有沒有大魚海棠的八卦	中國人自己都在噴了
為什麼台灣公共澡堂不興盛？	台灣人不洗澡
武則天很猛嗎？	張柬之那批人也是等到她快病死了才敢政變
google 過濾條件 痞客邦篩選機制	這垃圾廣告文真的超多，現在搜索東西都麻煩了點
客運拋錨在高速公路上怎麼辦	等等他會叫另一台車過來 之後會收到折扣券
下著雨的夜晚最美 對不對？	愛情的盡頭
有沒有挺同政治正確到誇張的八卦	台灣連同婚都有人在反 怎麼可能立反歧視法
刻意節食反而胖更快	身體沒動力代謝 QQ
東南亞伊斯蘭教是怎樣的存在？	世俗化....應該說很難把原始教義拿出來用
看動漫=宅 看韓劇就不宅?	你是第一個說鬼怪很糞的人
去採集生態樣本要注意什麼？	要注意 不要隨便大便
ILoveElsa	男版女版都想吃喔 胃口很大欸
清華是不是很多幼鳥會被路殺	宿舍前晚上有點暗如果小鳥掉下來確實會看不到碾過去
想到什麼食物可以代表臺灣?	雞排+珍奶
國考跟四大哪個難考	四大考國考根本輕鬆
平溪天燈節瑞芳接駁車	你國手喔，跑這麼快
有沒有哆啦A夢怎麼染藍的八卦？	應該是家產被抄，難過到變藍了
跟學弟妹去KTV	乖乖當分母
台灣哪個姓氏最帥的八卦?	姓陳的帥的最多人
有沒有鋼鐵神兵B'TX動畫的八卦	覺得主角頗廢
朱延平要重拍七匹狼	永遠不回頭
為何警察 消防員 監所管理員都沒抗議排班	什麼時候沒抗議了，平行世界？消防員不知抗議幾次了
肥宅是不是都很喜歡甲甲？	這世上如果殺人合法 你猜有多少甲甲會被殺死
8+9的耳朵構造有一不一樣嗎	所以機車要拔掉消音器啊，不然會以為沒發動
看高國豪打球真是舒服 	冠軍賽跟我說
結衣如果不愛刷牙…	拜託 結衣就算不刷牙口中也有玫瑰香氛 你是懂個屁
肉圓要ㄘ蒸的還炸的？	這問題兩三天就有人問一次
有人拉過飛機上救生衣的拉環嗎？	你沒搭過飛機對吧。有相關規定喔　ㄎㄎ
打哈欠會不會傳染	看了這篇打了個哈欠
下ㄇ一ㄢ給我吃	整天秋秋秋秋　　你說秋就秋　我說不許秋
在國外被中國人霸凌的八卦	在國外就tough一點 幫台灣人爭一口氣
有沒有孩子躺在公車上的八卦	把他移開，坐下去
八卦狼師們會誘姦姆咪嗎?	姆咪姆咪星爆爆 姆咪姆咪西雞 雞
有沒有優越感才是進步的最大動力的八卦	我覺得是耶，不過這種動力撐不久
有長相空靈的肥宅嗎	在聖人模式下兩眼無神算空靈嗎
大強躲到衣櫃底下怎麼辦	發射戰斧導彈
客運司機到底在聊什麼？	長途開車不聊才危險吧
憂鬱的人是不是也有分等級？	有分等級喔 一堆人在分享憂鬱症多想死 都還算有救
有沒有橘園素食料理的八卦	幫高調！無限上綱無限嗆酸的一家店！非常狂！
有車有房的車跟房的標準是??	房三千萬  車兩百萬   大概這樣八
嗯 的俄語要怎麼講?__?	ну 這個還蠻常聽到的
Gakki跟邵庭誰比較正？	三小你選圖能力有問題?
嗯 的琉球語要怎麼講	ㄇㄧㄝ休幹某 我記得是這樣
怎麼一套好看的童裝隨便就上萬?QQ	去買1/2...很便宜..
新聞畫面	哇操，美術人員勒
中國經濟垮掉誰會受害？	韓國第一慘 第二就是台灣
有沒有戴奧辛是假議題的八卦	觀音工業區的蓋好一陣子了……
從小到大哪本課本最沒有用?	美術都拿去上數學了 整學期有沒有翻過3次都不知道
嗯 的客家語要怎麼說？	meshowgunmo
科學家是用什麼方法找外星人的？	物質和能量能轉換，才能超越一定速率，在宇宙旅行
台中有哪些美食	不知道，只知道大麵羹超爆幹難吃的極品噴
要如何成為亞洲空洞王？	10樓亞洲腦洞王
肥宅聽到什麼案件會氣噗噗?	初音被證明只是個軟體
有沒有女生都有男朋友的八卦	你有問角落那個女肥宅嗎
為啥還有陸客有卦嗎	什麼時候你有禁陸客的錯覺
看到好尻的做作品大家會如何做?	找鄰居一起演
各國可以騎的特產中，誰最強	台灣是台女CCR任人騎
二戰國軍其實很猛	太多關鍵字 意圖使人崩潰
台灣省最發達的城市是新竹還是竹北	最發達我不知道，不過最阿達的是新北
有沒有遇到佐藤和真該怎麼辦的八卦?	第三季什麼時候出啦
火車站遺失Roots真皮背包	去南部板好嗎
坐客運很擠的八卦	客運全坐票，哪裡擠？
jolin被男生傷害那麼多次 會變同性戀嗎	人家行情很好你不用擔心
交大的特色是?	不像高應大學生品行這麼差
到底賣什麼的？（填問卷，愛心筆？）	很好 女生屁股有線的概念
沒被選上TWICE的人在想什麼?	誰跟你走後門 靠實力好嗎
大夜班時薪應該要多少？	麥當勞大夜時薪是日班的1.5倍
沒開罐器怎麼辦	再出門一次，去買開罐器啊
吃飯時對方一直滑手機怎麼辦？	學弟 你真的太無聊 我只好一直滑手機
情人節忘記跟左右手%%%怎麼辦?	你不講我還真忘了，只顧著吃我的炸雞
有人看過科學怪校車嗎	箱行車系列有看過啦o'_'o
遊覽車司機有無團體保險?	未看先猜 連司機都沒勞保
有沒有催眠術的八卦?	恭 喜 發 財
我跟結衣醬公開的那天大家會祝福我們嗎	別傻了 已經是哥的形狀了
小姐都到了才說不想幹的八卦	那位朋友的懶覺還在身上嗎
迪士尼木蘭是不是應該拿大龍炮射單于滿臉	會成為皇上最後的希望
為什麼DPP不給基隆再多點建設	車站改建完像公廁.....
有柬埔寨新娘的八卦嗎?	#還有寮國
社工師的卦	執業要先加當地的公會，然後跟當地政府主管機關申請
歌手現場表演很爛的八卦?	常自稱感冒的那幾個  剩下的都說耳機有問題
大過年撲克牌遊戲的霸主是哪種?	射龍門啊 幹超刺激
烏骨雞的生殖器有比較大嗎?	被你講一講想吃烏骨雞湯
有沒有清晨5點就敲鑼打鼓的八掛	那些家裡面有人跑宮廟的不覺得羞恥嗎？
王保芳夫婦當時為什麼沒報警？	怎麼會覺得陳、高兩人會一起動手術？這個問題也太